0000000000000000000000000000000000000000
0000001111111100000010000111111111000000
0000001000000000000101000000010000000000
0000001111111100001000100000010000000000
0000001000000000011111110000010000000000
0000001000000000010000010000010000000000
0000001111111100010000010000010000000000
0000000000000000000000000000000000000000
0000000001000000011111000011111000000000
0000000010100000100000000100000000000000
0000000100010000011110000011110000000000
0000001111111000000001000000001000000000
0000001000001000000001000000001000000000
0000001000001000111110000111110000000000
0000000000000000000000000000000000000000
0000000000000000000000000000000000000000
00000000000000000000000000?0000000000000
0000000000000000000000000000000000000000
0000000000000000000000000000000000000000
5555555555555555555555555555555555555555
1111111111111111111111111111111111111111
0111111111111111111111111111111111111110
0001111111111111111111111111111111111000
0000601111111111111111111111111111060000
0000000000111111111111111111111000000000
0000000000666011111111111110666000000000
0000000000060000011111110000060000000000
0000000000000000006666600000000000000000
0000000000000000000666000000000000000000
0000000000000000000060000000000000000000