1111111111111111111111111111111111111111
1        1111111114                    1
1        111111114                     1
1        1111114                       1
1        111111         211111111118   1
1        111111         1              1
1        511114         1              1
1                918    118  91111111111
1                       1             51
1                       1             pp
1            91118      1             pp
1                       1             pp
1                       1             pp
1                       1    91111111111
1            913   211111       51111111
1              1   111111          51111
1  9118        1   111111           1111
1              1   111111           1111
1              1   111111           1111
1          91114   511114           1111
1                                   1111
1                           1      21111
1    9118                        2111111
1                         f      1111111
1111111111111111111111111111111111111111
1111111111111111111111111111111111111111
1111111111111111111111111111111111111111
1111111111111111111111111111111111111111
1111111111111111111111111111111111111111
1111111111111111111111111111111111111111